R  1000 1000

NO ./textures/10.xpm
SO ./textures/10.xpm
EA ./textures/10.xpm
WE ./textures/10.xpm
S  ./textures/3.xpm

C  4, 0, 31
F  4, 0, 31

11111111111111111111111111111111111111111111111111
10000000000000000000000000000000000000000000000001
10001100011000110001100011000110001100011000110001
10001100011000110001100011000110001100011000110001
10020000000000000000000000000000000000000000002001
100020000000000000000000W0000000000000000000020001
10020000000000000000000000000000000000000000002001
10001100011000110001100011000110001100011000110001
10001100011000110001100011000110001100011000110001
10000000000000000000000000000000000000000000000001
11111111111111111111111111111111111111111111111111