R  1000 1000

NO ./textures/bluestone.xpm
SO ./textures/colorstone.xpm
EA ./textures/eagle.xpm
WE ./textures/greystone.xpm

S  ./textures/barrel.xpm

C  10, 255, 255
F  0, 255, 0


        111111111111111111111111111111
        100000000011000000S00000000001
        100100000111000000000000111111
        100100000000000000200000111111
11111111101100000111000000000000111111
10000000001100000111011111011111111111
11110111111111011100000010001
11110111111111111111000111011
11110111111111011101010010001
11000000000101011100000010001
10000000000000001100000010001
10000000000000001101010010001
1000000111010101111101111020111
10000111 1110101 101111010021
11111111 1111111 111111111111